103015: 0
103019: 1
103020: 2
103030: 3
103032: 4
103033: 5
103066: 6
